NO ./texture/nord-_1_.xpm
C	250,145,145
SO ./texture/sud-_1_.xpm
WE ./texture/west-_1_.xpm
F	135,135,139
EA ./texture/east-_1_.xpm

    1111111111111111111111111                       
111110000000000011111111111111111111111111111111111111111111111111111111111
11111011111111101110000000000000000000000000000000000011111                       
1111101111111110000011111111111111111111111111111111101111111111
111110111000001111111100000000000000000000000000000000000011111111111111111
11111000001110111100000011111111111111111111111111011111101111111111111111
111111111111101111111111                       111111111011111
111000000011000000000001                        10000000001111
1011000001110000001000001                       111111111111111
1101000000000000000000000111111111
111111111011000001110000000000001
10000000001100000111011111111111
11110111111111011100000010001
11110111111111011101010010001
11000000110101011100W0001000111             11
1000000000001  1001100000000001             101
100000000000010001010100100111               11
1100000111010101111101111000111
11110111 1110101 101111010001
111111111111111111111111111111
11111111 1111111 111111111111